
















































































1111
1001
1W01
1111
